r:11
c:15
. . . . . . . . . . . . . . .
. . . . . . . . . . E . . G .
. . . . . . . X . X X X X X .
. C . . E . . . . . . . . . .
. X X X X X . . . . C . . . .
. . . . . . . . . . X X . . .
. . . . . . . X X X . . X . .
. P . . . . . . . . . . . . X
. . . . . . . . . . . . . . X
. . . . . . . C . . . . X X X
X X X X X X X X X X X X X X X